Super Fields
19 21
566 638 638 597 66 720 720 631 634 634 634 638 638 638 638 634 598 384 524 459 460
130 599 634 635 603 597 631 598 66 66 66 599 638 638 598 130 384 524 524 459 460
130 130 130 130 599 638 598 66 66 66 66 66 636 605 130 130 495 524 523 491 460
130 130 720 720 130 600 66 66 950 951 952 66 599 605 130 720 495 524 523 523 545
743 720 784 785 720 632 66 66 982 983 984 66 66 600 130 720 559 524 523 523 491
459 497 816 817 720 600 66 66 876 876 876 720 66 600 130 130 652 559 523 523 523
459 460 497 720 130 632 66 66 66 66 66 66 66 600 130 130 130 652 559 523 523
459 460 496 130 130 636 630 66 66 720 66 66 66 600 130 932 130 130 652 559 715
459 460 592 130 130 599 606 630 66 66 66 66 66 2 130 981 981 130 130 130 932
748 592 652 130 130 130 604 634 570 539 570 539 34 606 630 130 981 816 817 130 130
652 652 130 130 130 130 600 4 130 130 130 130 130 599 606 630 130 848 849 130 130
130 130 130 130 130 596 605 130 130 932 130 130 130 130 599 634 539 630 130 130 932
130 130 130 130 596 634 598 130 130 720 130 130 130 130 130 130 130 600 130 130 130
130 130 130 4 600 130 981 804 130 130 130 720 130 804 981 981 4 600 130 816 817
130 130 631 570 605 130 981 981 130 130 720 130 130 130 981 981 631 605 130 848 849
631 603 605 130 599 630 130 130 130 130 130 932 130 130 130 130 604 634 630 130 130
606 606 605 130 130 599 630 130 720 130 130 130 720 720 130 130 600 130 599 539 630
606 606 598 130 720 130 600 130 674 130 130 816 817 720 130 631 598 130 130 130 600
606 598 130 720 835 130 600 130 130 674 720 848 849 130 4 600 130 130 963 631 605
